##########
#A.....B.#
#.####...#
#........#
##########
